11111111111111111111111111111111 
1111010001110011111111        1
1100110111N10111111111          1 
11111110001100111111          1
111111111111111111111111111111111