1111111
1000001
100N0 1
1000001
1111111
