NO ./textures/north.xpm
SO ./textures/south.xpm
WE ./textures/west.xpm
EA ./textures/east.xpm

F 184,113,39
C 51,198,227

11111111111111111111111111111111111111111111111
10000000000000000000000000000000000000000000001
10000000000000000000000000000000000000000000001
10000000000000111111111111111111110000000000001
10000000000000100000000000000000010000000000001
10000000000000100000000000000000010000000000001
10000000000000100000111111110000010000000000001
10000000000000100000100000010000010000000000001
10000000000000100000100000010000010000000000001
1000000111111110000010000001000001111111000001
1000000100000010000010000001000001000001000001
1000000100000010000010000001000001000001000001
1000000100N00010000010000001000001000001000001
1000000111111110000010000001000001111111000001
10000000000000100000100000010000010000000000001
10000000000000100000111111110000010000000000001
10000000000000100000000000000000010000000000001
10000000000000100000000000000000010000000000001
10000000000000111111111111111111110000000000001
10000000000000000000000000000000000000000000001
10000000000000000000000000000000000000000000001
11111111111111111111111111111111111111111111111
