11111
1C0E1
10001
1P0C1
11111
