NO ./textures/north.xpm
SO ./textures/south.xpm
WE ./textures/west.xpm
EA ./textures/east.xpm

F 0,0,0
C 12,150,255

 1111
10001      111          
1N001      101
1111       111

1111
1001
1001
1111

